+---------------------+
| : : | : : : : | : : |
| : : : : : | : : | : |
| : : : : : :B| : : | |
| : : : : : : : | :G: |
| : : : | : : | : : | |
| | : : : : : : : : : |
|Y: : : :R: : : : | | |
| | : : : : : : : : | |
| : : : : : | : : : | |
| | : : : | | : : : : |
+---------------------+
