+---------------------+
| : : : |R: : : : : : |
| | : | : | : : : : : |
| : : : : : : : : : : |
| | : : | :Y: :G: | : |
| | :B: : | : | : | : |
| : : : : : : : : : : |
| : : : : : | : : | : |
| : : : : : : | : : : |
| : : : : : : : : : : |
| : : | : | : | : : : |
+---------------------+
