+---------------------+
| | : : | | : : : : : |
| | : : : : : : : : : |
| : : | | : : | : : : |
| | | | | : : : : : | |
| : : : : : | : : | : |
| : : : : : : : | : : |
| : : | : : : : | : : |
| : | : : : | : : | : |
| : : | : :R:B| : : | |
| : : : | : :Y|G: : : |
+---------------------+
