+---------------------+
| : : : | | | : : : : |
| : : :R| : : | : : :G|
| | : : : | | : : :Y: |
| : : | : : : | : | : |
| | : : | | : | : : :B|
| : | : : : : : : : : |
| | : : : : : | | : : |
| : : : : | : : : : : |
| : : : | : : : : : : |
| : : : : : : : : | : |
+---------------------+
