+---------------------+
| : : : : : | : : | : |
| : | : : : : | : | | |
| : : : | : : : : : : |
| :G: : : : : : : : | |
| : : | : | : | : | : |
| : : : : : : : : : : |
| | : | : : : : : : : |
| | | : : : : |Y| : :R|
|B: : : : : | : : : : |
| : : : | : : : : : : |
+---------------------+
