+---------------------+
| : : : : : : : : | : |
| :B: : | : | : : : :G|
| | : :Y: : | : : : : |
| : | | | : | : | : : |
| : | : : : : : : : : |
| : : : | : : | : : | |
| : : : | | : : : | | |
| : : : : : | : : : : |
| : : : : : : : | | : |
|R: : : : : : : | : | |
+---------------------+
