+---------------------+
| : : | | | : : : : : |
| : : | :Y: : : : : :B|
| : : : : : : | : : | |
| | : : : : : : | | | |
| : :G: : | : : : | | |
| : : : : : | | | : : |
|R| : : : : | : : : | |
| : : | | | : : : : : |
| : : : : | : | : | : |
| : : | : | : : : | | |
+---------------------+
