+---------------------+
| : | : : | : : : : | |
| : : : : : : | : : | |
| | : : | : : :G: : : |
| | : : | : : : | : | |
| : : | : : : | : : : |
| | :Y: : | | : : : : |
| : :R: : : : : | : | |
| :B: : : : : : | : | |
| : : : : | : : : : : |
| : | : | | : | | : | |
+---------------------+
