+---------------------+
|R| : : : : : : : :G: |
| | | | | : | : | : | |
| :Y: : : | : | : | | |
| | : |B| | : : : | | |
| | : : : | : : : | | |
| | : : : | : : : | | |
| | : : : | : : : : : |
| | : : : : : : : : : |
| : : : : : : : : : : |
+---------------------+