+---------------------+
| : | : | | : :B: : :G|
| | : | : : | : : : : |
| : : : : | : | : : : |
| : | : : : : : : : : |
| | : : | | : : : | : |
| | | : : | | : : : | |
| : | | : | : : : : : |
|Y: : : : : : : : | : |
| : : : : | | : : : :R|
| | | : : | : : : | | |
+---------------------+
