+---------------------+
| | : : | : : : | | : |
| | : | : : : : | : | |
| : : | : : : : : : : |
| : : : | : :Y: | : | |
| : | : : | : | | | | |
| : | : | : : : : : | |
| | : : | : :G: : : : |
| : : | : : : : | :B: |
| | : : : : |R| : | : |
| | : : : | | : : : : |
+---------------------+
