+---------+
| : : : : |
| :Y: : : |
| : | : : |
| : | :G:B|
| : :R: | |
+---------+
