+---------+
| : | : |G|
| : : : : |
|Y| : : : |
| : : : : |
|R| : |B: |
+---------+
