+---------+
| : : : : |
| | : | : |
| : : : : |
| : : : :Y|
| :B:R|G: |
+---------+
