+---------+
| :Y|G: : |
| : | : : |
| : : : : |
| : : | :B|
|R: : | : |
+---------+
