+---------+
| : : : :Y|
| :G:B: : |
| : : : : |
| : :R| : |
| | | : : |
+---------+
