+---------+
| | :G:Y: |
| : : :R| |
| : : : | |
|B| : | | |
| : : | | |
+---------+
