+---------+
| | |R: : |
|B| : | : |
| |Y: : : |
| : : | : |
|G| : : : |
+---------+
