+---------+
| : | : : |
| :R|Y: : |
| : :G: : |
| | : | :B|
| | : | : |
+---------+
