+---------+
| | : :B: |
| : |Y:G  |
| : : : : |
| : : | :R|
| | : | : |
+---------+
