+---------+
| | : : : |
| : : : : |
| : : | : |
|B:G:R| : |
| : : : :Y|
+---------+
