+---------+
| : | : : |
| : : : | |
|G|B: : : |
|R: | | : |
| : :Y: : |
+---------+
