+---------+
|R| : : :G|
| | | | : |
| :Y: : | |
| |B| | : |
| : : : : |
+---------+