+---------+
| : : : :Y|
| :G| : :R|
| : | : : |
| | : : : |
| | : :B: |
+---------+
