+---------+
| :Y| :G: |
| : | : : |
| : : : : |
| | : | :B|
| |R: | : |
+---------+
