+---------+
| : : : : |
| : : : : |
|Y:G: : : |
|B|R: : : |
| : : : | |
+---------+
