+---------+
| : | : : |
| : | : : |
|B: : :Y: |
| : : : : |
| | :R|G: |
+---------+
