+-----------+
| : : | : : |
|B: : | : | |
| : : : | :Y|
|R: : : : : |
| :G: : | : |
| : : : | : |
+-----------+
