+-----------+
| :R| : : :G|
| : | : | : |
| : | : | |B|
| : : : : : |
| : : : : : |
| : |Y: : : |
+-----------+
