+-----------+
|R| : : :G: |
| | | | : | |
| :Y: : | | |
| |B| | : : |
| | : : : : |
| : : : : : |
+-----------+