+-----------+
| : : | : : |
| : | : : |Y|
| : : : | | |
| | : : : |G|
| : : : : : |
|B:R: : : : |
+-----------+
