+-----------+
| : : : | | |
| : : :G: : |
| : :R: : : |
| |Y: : : : |
| :B: : : : |
| : : : : : |
+-----------+
