+-----------+
| : : : : : |
| :G: : | | |
|B: : : | : |
| : : : : | |
| : :Y: : : |
| | : :R| : |
+-----------+
