+-----------+
| : : : : |R|
| : : : | : |
| : : | : | |
| : : :B: : |
| : : | | : |
| : :Y: | :G|
+-----------+
