+-----------+
| | | : : | |
| | : : | :R|
| | : : | :G|
| : : | : : |
| : : :Y: : |
| : : : : |B|
+-----------+
