+-----------+
| | | :B: : |
| : | | :G| |
| : : | : : |
| : :Y: : : |
| : : : : : |
| :R: : : : |
+-----------+
