+-----------+
| : : : |Y: |
| : | : : | |
| :G: | | | |
| : :R: :B| |
| | : : | : |
| : : : | : |
+-----------+
