+-----------+
|B: :G: : :Y|
| : : | : : |
| : | : : | |
| | : : | : |
| : : : : : |
| : : :R| : |
+-----------+
