+-----------------+
| | : | | : : : : |
| : : :G: : | | : |
| : | : : : : : : |
|B: : | : : : | : |
| : | : : : : : : |
| :R| : : : : : | |
| : : | | : | : : |
| : | : : : : |Y: |
+-----------------+
