+-----------------+
| : : : | : : : : |
| : | : | :B| : : |
| : : | :R: : : :G|
| : | : : : : : | |
| | : | : : | : : |
| : | : : | : | | |
| | : : : : : : | |
| | : : | : :Y: : |
+-----------------+
