+-----------------+
| : | | : : : : | |
| | : : | : : | : |
|R: : : : : : : : |
| : : : : : : | : |
| : :B| : : : : : |
| | : : : : : : : |
| : : : :G: :Y: : |
| : : : : : | : : |
+-----------------+
