+-----------------+
|R| : : : : : :G: |
| | | | | : : | : |
| :Y: : : | : : | |
| | : |B| | : : : |
| | : : : | : : : |
| | : : : | : : : |
| | : : : : : : : |
| : : : : : : : : |
+-----------------+