+-----------------+
| : : |Y: : : : :B|
| : : : : : : | | |
| : : : : | : : | |
| : : : : | | : :G|
| : | : : : :R: : |
| : : : : : : | : |
| | : : : : : : : |
| : : : : : | | : |
+-----------------+
