+-----------------+
| | : : | : : : : |
| | : : : | : | : |
| : : : |B: : : : |
| : : : : : | : : |
| : : :Y| : : |G: |
| : : | : : : : : |
| : : : | : : | | |
| : : : : : |R: | |
+-----------------+
