+-----------------+
| : : : | : : : :Y|
| : : : : | : : | |
| | | : : | : | | |
| |B: : :G: : | : |
| : : : : : : |R: |
| : : : : : | : | |
| : : | : : : | : |
| | : : | | : : : |
+-----------------+
