+-----------------+
| | : : | | : : :G|
| | : : : | : : : |
| | : : : | : : :B|
| :R: | : : : : : |
| : | : : : : | : |
| :Y| : | : : : : |
| : : : : : : : : |
| : | : : | | | : |
+-----------------+
