+-----------------+
| | : : : : : : :Y|
| | : : : : : : : |
| : : | : | : : : |
| :R|G: : : | : : |
| | : : | : : | : |
| : : : | | | | : |
| : : | : :B| | | |
| : | : : : : : | |
+-----------------+
