+-----------------+
| | | : : : : : : |
| : | | | : | : : |
| : : : : | : : | |
| :Y| : | | : :B: |
| : : : : : : : | |
| :R| | : : : | | |
| | : : : : | : | |
| : : : : | : |G: |
+-----------------+
