+-----------------+
| | : : :R: : : : |
| : : : : : :Y: : |
| | : | : | : : :G|
| : | : : : | : | |
| : | : : : : : : |
| : : : : | : : :B|
| : : | : | : : | |
| : : : | : : : : |
+-----------------+
