*****X***X*****X***X
XXXX*X*X*X*XXX*X*X*X
***X***X*X*X*X*X*X*X
*X*XXXXX*X*X*X*XXX*X
*X*****X***X*X***X*X
*XXXXX*XXXXX*XXX*X*X
***X***X*********X*X
*X*X*XXX*XXXXXXX*X*X
*X*X*X***X*****X*X*X
XX*X*X*XXX*XXX*X*X*X
***X*X*X*X*X***X***X
*XXX*X*X*X*X*XXX*XXX
*X***X*X***X***X*X*X
*X*XXX*X*XXXXX*X*X*X
*X***X*X***X***X***X
*XXX*X*XXXXX*X*XXXXX
***X***X***X*X***X*X
XX*XXXXX*X*X*X*X*X*X
*********X***X*X****
XXXXXXXXXXXXXXXXXXX*