1111111111
0000000000
0000000000
0000000000
00000F0000
1111111111
00000P0000
0000000000
0000000000
1111111111