########################################
#XXXXXXXXXXXXXXXXXXXXXXXXXXXXXXXXXXXXXX#
#XXXXXXXXXXXXXXXXXXXXXXXXXXXXXXXXXXXXXX#
#X                                    X#
#X XXXXX XXXX X XXXXXXXX X XXXX XXXXX X#
#X X            X      X            X X#
#X X XXXXXXXXXX X XXXX X XXXXXXXXXX X X#
#X X X   X   X  X      X  X   X   X X X#
#X     X   X   XX XXXX XX   X   X     X#
#X XXXXXXXXXXX X        X XXXXXXXXXXX X#
#X           X X XXXXXX X X           X#
#X X XXXXXXX X X        X X XXXXXXXXX X#
#X X X       X X X XX X X X X       X X#
#X X X XXXXX X X X XX X X X X XXXXX X X#
#X X X XXXXX X X X XX X X X X XXXXX X X#
#X X                                X X#
#X X XXXXXXXXXXX X XX X XXXXXXXXXXX X X#
#X                                    X#
#X XXXXXXXXXXXXXXX XX XXXXXXXXXXXXXXX X#
#X XXXXXXXXXXXXX        XXXXXXXXXXXXX X#
#X         XXXXX XXXXXX XXXXX         X#
#X XXXXX X       X    X       X XXXXX X#
#X     X XXX XXXXX XX XXXXX XXX X     X#
#X X X X   X                X   X X X X#
#X   X XXX X XXX X XX X XXX X XXX X   X#
#X X X   X X X   X XX X   X X X   X X X#
#X X   X       X X    X X       X   X X#
#X X XXXX X XXXX XXXXXX XXXX X XXXX X X#
#X        X                  X        X#
#XXXXXXXXXXXXXXXXXXXXXXXXXXXXXXXXXXXXXX#
#XXXXXXXXXXXXXXXXXXXXXXXXXXXXXXXXXXXXXX#
########################################