########################################
#                                      #
#                                      #
#                                      #
#                                      #
#                                      #
#         #####################        #
#         X                   X        #
#         X XXX X  XXX  X XXX X        #
#         X XXX X       X XXX X        #
#         X XXX X  X X  X XXX X        #
#         X     X  X X  X     X        #
#         X XXXXX  X X  XXXXX X        #
#         X X               X X        #
#         X X XXXXXX XXXXXX X X        #
#                                      #
#                                      #
#                                      #
#         X XXX X  XXX  X XXX X        #
#         X XXX X       X XXX X        #
#         X XXX X  X X  X XXX X        #
#         X     X  X X  X     X        #
#         X XXXXX  X X  XXXXX X        #
#         X X               X X        #
#         X X XXXXXX XXXXXX X X        #
#         X                   X        #
#         XXXXXXXXXXXXXXXXXXXXX        #
#                                      #
#                                      #
#                                      #
#                                      #
########################################