 -------------------------------------- 
|                                      |
|                                      |
|                                      |
|                                      |
|                                      |
|                   .                  |
|                  . .                 |
|                                      |
|                   .                  |
|                  ...                 |
|           ..    .....    ..          |
|           .    .......    .          |
|               ...   ...              |
|              ...     ...             |
|             ....     ....            |
|              ...     ...             |
|               ...   ...              |
|           .    .......    .          |
|           ..    .....    ..          |
|                  ...                 |
|                   .                  |
|                                      |
|                  . .                 |
|                   .                  |
|                                      |
|                                      |
|                                      |
|                                      |
|                                      |
|                                      |
 -------------------------------------- 