................
................
.......O........
................
...XXXXXXXXXX...
................
................
................
................
................
